EA ./libft/Makefile
NO ./Makefile 
SO ./libft/ft_bzero.c
WE ./libft/ft_isdigit.c

F 255,255,0
C 0,0,255


111111111111111
100000000000001
100111000010001
100100000010001
100100000010001
100100000010001
100100100001001
100000000000001
100000000000001
100000000000001
100000000000001
100000000000001
10S000001111001
100000000000001
111111111111111


